Từ	B B
những	B B
năm	B B
1990	I B
,	B B
Nguyễn	B B
Thái	I I
Tài	I I
đã	B B
được	B B
nhiều	B B
người	B B
biết	B B
tới	B B
do	B B
được	B B
xem	B B
là	B B
nam	B B
giới	I I
đầu	B B
tiên	I I
hành	B B
nghề	I I
trang	B B
điểm	I I
chuyên	B B
nghiệp	I I
cho	B B
phái	B B
đẹp	I I
,	B B
góp	B B
phần	I I
đưa	B B
nhiều	B B
người	B B
mẫu	I I
,	B B
hoa	B B
khôi	I I
,	B B
hoa	B B
hậu	I I
lên	B B
bục	B B
vinh	B B
quang	I I
.	B B
